####################
#E#E##########.EEE.#
#.#.#E......E#.EEE.#
#.#.####.#######.###
#......#...E#....###
######.#.####.######
#..................#
#..................#
#..................#
#..................#
#.........@........#
#..................#
#..................#
#..................#
#..................#
#..................#
#..................#
#..................#
#..................#
####################